96275.8.1
..71...5.
......26.
..85.....
.7.......
61927....
..5...12.
19....4..
.......78