.....5..7
....67...
.........
.3.5..48.
..9..1..6
.14..67..
....79.53
.9768.1.4
..8......