5.3...89.
19.......
.......57
.71..638.
.2....6..
6...2..7.
8.5..1...
21......6
....5....