..47....9
.27......
..9.8....
..8.4.9.6
....6.82.
..58..7..
...5...61
.9.......
.72.....5