75.6.3.82
.4.......
2.6......
.27...9.5
..8......
...5.....
....3....
6..8..357
..927...8