Facile
609|800|752
501|670|489
020|040|000
-----------
000|400|070
005|000|904
304|900|160
-----------
208|396|507
003|200|091
006|007|000